208 15
................................................................................................................................................................................................................;
................................................................................................................................................................................................................;
.....................................................................................................................................................................................................<|.........;
......................................................................................................................................................................................................|.........;
................................................................................g.g...................................................................................................................|.........;
......................Q.........................................................BBBBBBBBB...BBBQ..............2...........BBB....BQQB.................................................................|.........;
.............................................................................................................................................................................................HH.......|.........;
............................................................................................................................................................................................HHH.......|.........;
...........................................................................................................................................................................................HHHH.......|.........;
................Q...B2BQB....................................................B2B...............Q.....B3....Q..Q..Q.....B..........BB......H..H..........HH..H............BBQB.............HHHHH.......|.........;
.........................................................................................................................................HH..HH........HHH..HH...........................HHHHHH.......|.........;
........................................................................................................................................HHH..HHH......HHHH..HHH........................HHHHHHHH.......|.........;
.......m..............g.....P2........P3g.....P4...g.g...P4.......................................g.g.......k......g.g.......g.g.g.g...HHHH..HHHH....HHHHH..HHHH....P2.........g.g..P2HHHHHHHHH.......H...#.....;
GGGGGGGGGGGGGGGGGGGGGGGGGGGGGGGGGGGGGGGGGGGGGGGGGGGGGGGGGGGGGGGGGG..GGGGGGGGGGGGGGGGGG...GGGGGGGGGGGGGGGGGGGGGGGGGGGGGGGGGGGGGGGGGGGGGGGGGGGGGGGGGGGGGGGGG..GGGGGGGGGGGGGGGGGGGGGGGGGGGGGGGGGGGGGGGGGGGGGGGGGGGG;
GGGGGGGGGGGGGGGGGGGGGGGGGGGGGGGGGGGGGGGGGGGGGGGGGGGGGGGGGGGGGGGGGG..GGGGGGGGGGGGGGGGGG...GGGGGGGGGGGGGGGGGGGGGGGGGGGGGGGGGGGGGGGGGGGGGGGGGGGGGGGGGGGGGGGGG..GGGGGGGGGGGGGGGGGGGGGGGGGGGGGGGGGGGGGGGGGGGGGGGGGGGG;

// blocks are upper case   : B = Brick 
//                           G = Ground
//                           H = Block 
//                           Q = Question Block

// Combined Blocks         : P[#] = Pipe and Height of Pipe (pipes are always 2 wide and 2 high)

// Special Blocks          : 1 = Brick Coin 
//                           2 = Q-Block Guaranteed Mushroom 
//                           3 = Brick Starman 
//                           # = Castle 
//                           | = Pole
//                           < = Flag

// entities are lower case : p = PringleMan; g = Goomba; k = Koopa